----------------
----------------
----------------
----------------
----------------
----------------
----------------
----------------
------####------
------####------
----########----
----########----
################
################
################
