----------######
----------######
----------######
----------######
----------######
----------######
----------######
----------######
----------------
----------------
----------BB##BB
----------BB##BB
################
################
################
