##-#############
##-#############
##--HHHHHHHHHHHH
##--------------
##--------------
##--------------
##--------------
##--------------
##--------------
##--------------
##--------------
##--------------
####------------
####HHHHHHHHHHHH
################
