##|#############
##|#############
##|---##------##
##|---##------##
##----##--##--##
##----##--##--##
##----##--##--##
##----##--##--##
##----##--##--##
##----##--##--##
##--------##--##
##--------##--##
##--------##--##
#########-###|##
#########-###|##
