################
################
################
################
################
################
##--------------
##--------------
##--------------
##--------------
##------------##
##------------##
##|#############
##|#############
##|#############
