################
################
--------BBBB--##
L-------BBBB--##
############--##
############--##
--------------##
--------------##
----############
----############
--------------##
--------------##
#############|##
#############|##
#############|##
