-------------
-------------
-------------
-------------
-------------
-------------
-------------
-------------
-------------
-------------
----------###
----------###
#############
#############
#############
