####------------
####------------
####------------
####------------
####------------
####------------
####------------
####------------
########--------
########--------
############----
############----
################
################
################
