----------------
----------------
----------------
----------------
--------######-M
--------######--
----##########--
----##########--
##############--
##############--
##############--
##############--
##############--
##############--
##############--
