----------------
----------------
----------------
----------------
MMMMMMMMMMMMMMMM
----------------
----------------
----------------
-------MMMMMMM-M
----------------
----------------
----------------
---------------M
----------------
----------------
