----------------
----------------
----------------
----------------
M---------------
----------------
----------------
----------------
MMMMMM-MM-------
----------------
----------------
----------------
MMM-MMM-MMM-MMM-
----------------
----------------
