----------------
----------------
----------------
----------------
------##------##
------##------##
----######--####
----######L-####
################
################
################
################
################
################
################
