----------------
----------------
----------------
----------------
----------------
----------------
----------------
----------------
--------------##
--------------##
------------####
------------####
################
################
################
