----------------
----------------
----------------
----------------
----------------
----------------
----------------
----------------
###########--##-
#----#---#---#--
#----#---#---#--
#----#---#---#--
#----#---#---#--
#----#---#---#--
#----#---#---#--
