----------------
----------------
----------------
----------------
--------BB------
--------BB------
#####|####|#--##
-----|----|-----
-----|----BB----
-----|--P-BB----
-----|--BBBB----
-----|--BBBB----
################
################
################
