----------------
----------------
----------------
----------------
----------------
----------------
--------BB------
-##-----BB------
------####------
------####--##--
----######--##--
----######--####
##########--####
##########--####
##########--####
