##-----------|##
##-----------|##
##-----------|##
##-----------|##
####--------####
##------------##
##------##----##
####|#------####
##--|---------##
##--|---------##
##--|-BB------##
##--|-BB------##
#############|##
#############|##
#############|##
