##|-------------
##|-------------
##|-------------
##|-------------
##--------------
##--------------
##--------------
##--------------
##BBBB----------
##BBBB----------
####BBBB--------
####BBBB--------
################
################
################
