######|#--------
######|#--------
######----------
######-------HH-
########-----##-
########--------
####------------
####------------
##--------------
##-----##----##-
##--------------
##--------------
##--------------
##|#####HHHHHHHH
##|#############
