----------------
----------------
----------------
----------------
----------------
----------------
------##########
------##########
--##############
--##############
################
################
################
################
################
