----------------
----------------
----------------
----------------
----------------
----------------
----------------
----------------
############----
############----
##--------------
##L-------------
############|#--
############|#--
############|#--
