@@@VHV@@@@@@@@VHV@
@@@V@@@@@@@@@@V@V@
@@@V@@@@@@@@@@V@V@
@@@V@@@@@@@@@@V@V@
HHHV@@@@@@@@@@V@VH
