HHHHHHHHHV@
@@@@@@@@@V@
@@@@@@@@@V@
@@@@@@@@@V@
@@@@@@@@@VH
