HHHHHHHHHV@@@@@@
@@@@@@@@@V@@@@@@
@@@@@@@@@VHHHHV@
@@@@@@@@@@@@@@V@
@@@@@@@@@@@@@@VH
