--------------|#
--------------|#
--------------|#
--------------|#
-------#########
--##---------##-
----------######
------#----#####
------------####
-------------##-
-----#-------###
-----------#####
################
-------------##-
################
U
L