VVVVVVVVVVVVHHHH
HVVVVVVVVHHHHHHH
HHVVVHHHHHHHHHHV
VVVVVVVVHHHHVVVV
HHHHHVVHHHHHHVVH
VHHVHHHVVVHHVVVH
HHVVVHHHHHVVVVVH
VVVVVVVVVHHHHHHH
HVHHVVVVVVVVVHHV
HHHVVVVVVVVHHHHH
VVHHHHHHHHHHHHHH
HHHHHVVHHHHVVVVV
VVVVVVVVVVVVVVVV
HHHHHHHHHHHVVVVV
VVVHVHHHHHHHHHHV
VVVVVVVVVVVVVVHV
HHHHHHHVVVVVVVVH
VVVVVVHHVHHVVVVH
HHHHHHHHHVVVHHHH
VVVVHHVVHHHHHHVV
