VVHHHHHHHVVVV
HHHHHHHHHVVVV
VVVVVVHHHVVHH
VVVVVVHHHVVVV
VVVVVHVVVVVVV
HVVHVVHHHHHHH
VVVVVHVVVVVVV
VVVHHVVVVVHVV
VVVVVVVHVVVHH
VVVHHHVVVVVVV
