----------------
----------------
----------------
----------------
----------------
----------------
----------------
----------------
--##------##----
--##------##----
####----####----
####------##----
####--######--##
--##--######----
####------##--##
