--|-------------
--|-------------
--|-------------
--|-------------
--|-------------
--|--#---#---#|#
--|-----------|#
--|-----------|#
--|-----------|-
--|-----------|#
--|-----------|-
--|-----------|#
------########|#
HHHHHH--------|#
##############|-
