----------------
----------------
----------------
----------------
----------------
----------------
----------------
--------#---#---
----------------
----------------
-------#--------
----------------
--|##-----------
--|##HHHHHHHHHHH
--|#############
