--------##------
--------##------
-----##-##------
-----##-##------
--|####---------
--|####---------
--|--##-##------
--|####-##-----+
--|--##-########
--|####-########
--|####---------
--|####---------
################
-----##---------
################
