------##########
------##########
----------######
------########--
----------######
------##########
------##########
------##########
##############--
##############--
----------------
----------------
################
----------######
################
