----------------
----------------
----------------
----------------
----------------
----------------
----------------
####-----|####--
---------|------
---------|------
--------##------
----------------
--------------#C
HHHHHHHHHHHHHH##
HHHHHHHHHHHHHH##
