----------------
----------------
----------------
----------------
----------------
----------------
--------####----
--------####----
----##########--
----########----
################
--------########
################
--------####----
################
