-------------
-------------
-------------
-------------
-------------
-------------
-------------
-------------
-------------
-------------
----------#C#
----------###
#############
#############
#############
