----------------
----------------
----------------
----------------
----------------
----------------
-------------ll-
-------------##-
----##---######-
----##----------
--####----------
----##----------
################
----###########-
################
