############--##
############--##
############--##
############--##
#-------------##
#-------------##
#-------------##
#-www--lll----##
############--##
############--##
##------------##
##------------##
##--############
##--############
##--############
