----------------
----------------
----------------
----------------
----######------
----######------
################
################
################
################
################
################
################
################
################
