--------------##
--------------##
--------------##
--------------##
--------------##
--------------##
############--##
############--##
############--##
############--##
############--##
####----------##
####+---------##
############--##
############--##
