----------------
----------------
----------------
----------------
----------------
----------------
----------------
----------------
----------------
---------W------
---M----##---M--
--------##------
--------##------
--------##------
--------##------
