----------------
----------------
----------------
----------------
----------------
----------------
------------####
------------####
----############
----############
################
################
################
################
################
