----------------
----------------
----------------
----------------
----------------
----------------
----------------
----------------
----------------
----------------
----##----##----
----##----##----
################
################
################
