----------------
----------------
----------------
----------------
----------------
----------------
------------####
------------####
--------########
--------########
----############
----############
################
################
################
