------------#|##
------------#|##
-------------|##
-------------|##
----#|#--#######
----#|#--#######
----#|------####
----#|------####
----#|------####
----#|###---####
-----------#####
-----------#####
################
################
################
U
L