######------|---
#####-------|---
#####-------|---
######|#######--
######|#######--
####------------
####------------
##--------------
##--------------
##----##--##----
##--------------
##--------------
##--------------
######|#--------
######|#--------
D
U