-------------|##
-------------|##
-------------|##
------------####
------------####
--|#------######
--|#------######
--|-----#|######
--|-----#|######
--|------|----##
--|------|----##
--##-----|----##
--##-----|----##
--###---#####|##
--###---#####|##
U
D