###|############
###|############
##-|----------##
##-|----------##
##------------##
##------------##
####|-------####
##--|-------####
##--|-BB----####
##--|-BB----####
##--############
##--############
##--############
##|#############
##|#############
U
D