---|----##--|-##
---|----##--|-##
---|----##--|-##
---|----##--|-C#
--##----##|#####
--------##|#####
------####|---##
--------##|---C#
--##----####|-##
--------####|-##
------##----|-##
------##----|-##
--##|###|#######
--##|###|#######
--##|###|#######
U
D