--|#############
--|#############
--|-------######
--|-------######
--|-------######
--|-------######
------------####
------------####
---C----------##
--------------##
-----C--------##
--------------##
--------------##
############|-##
############|-##
U
D