##-----------|##
##-----------|##
##-----------|##
##-----------|##
##--------######
##------------##
#######-------##
##------------##
##--------######
##------------##
#######-------##
##------------##
##------P-----##
################
################
U
N