--|--#####--|-##
--|--#####--|-##
--|--#####--|-##
--|--#####--|-C#
--|--#####--|-##
--|--C####--|-##
--|--##-----|-##
--|--##-----|-##
--|--##|########
--|--C#|########
--|--##|------##
--|--##|------##
--##|#######|###
--##|#######|###
--##|#######|###
U
D