##-|############
##-|############
##-|--##########
##-|--##########
##--------------
##--------------
##--------------
##-----------|##
##-----------|--
##-----------|--
##------#C---|--
##------##--##--
##--#C--##------
##HH##HH##HHHHHH
##HH##HH##HHHHHH
R
U