##------------##
##------------##
##------------##
##------------##
##------------##
##------------##
##----##------##
####--##------##
####--##--##--##
####--##--##--##
####--##--##--##
####--##--##--##
####--##--##--##
####--##--##--##
####--##--##--##
D
U