--------------##
--------------##
--------------##
--------------##
--------------##
--------------##
######--####--##
######--####--##
######--####--##
####------##--##
####------##--##
--------------##
L-------------##
############--##
############--##
D
L