##|#############
##|#############
##|#####---#####
##|#####-L-#####
##|---####----##
##|---####----##
##|--------##|##
##|--------##|##
##-----------|##
##---##------|##
##---##------|##
##---##--#--#|##
##HHH##HH#HH#|##
#############|##
#############|##
U
D