#########-###|##
#########-###|##
HHHHHHHHH----|##
-------------|##
-------------|##
-------------|##
-------------|##
-------------|##
-------------|##
-------------|##
-------------|##
-----------ww|##
----------######
HHHHHHHHHH######
################
U
L