--------########
-------#########
------##########
-----###########
----############
---#############
--##############
--##############
--------------##
--------------##
--------------##
####--------ww##
----##tt########
----##tt########
----##tt########
D
L