----------###-##
----------###-##
--------------##
--------------##
--------------##
HH--HHHHHH----##
############-###
---------###--##
----------##--##
----------###-##
----------##--##
----------##--##
----------##|###
----------##|###
----------##-###
D
U