################
################
################
################
################
################
--------------##
--------------##
--------------##
--------------##
--------------##
--------P-----##
##########----##
##########----##
##########----##
D
L