##----##########
##----##########
##----##########
##----##########
##----##########
##----##########
##--------------
##--------------
##--------------
##--------------
################
################
################
################
################
R
U