##|-----------##
##|-----------##
##|-----------##
##|-----------##
##|--#--------##
##|-----------##
##|----#-----###
##|-----------##
##--------#---##
##-----P------##
##----####----##
##HHHH####HHHH##
################
################
################