--|--------#####
--|---------####
--|------------#
--|-----------##
--######|#-----#
----##--|#-----#
----##--|###---#
----##--|###----
----##--|-####|#
----##--|#####|-
----##--|----#|#
----##--|---L#|#
--------######|#
HHHHHHHH--##--|-
##############|#
U
D