----------------
----------------
----------------
----------------
##--------------
##--------------
##--------------
##--------------
##--------------
##--------------
##--------------
##--------------
##------------##
###|############
###|############
R
D