-------------|##
-------------|##
-------------|##
----------######
----------######
--------########
--------########
------##########
--|#--##########
--|#----------##
--|-----------##
--|-----------##
--|-----------##
##|#######--#|##
##########--#|##
U
D