---|--##########
---|---#########
---|------######
---|-------#####
---|--------####
---#####----####
------------####
------------####
---#|###########
----|-------####
----|---------##
----|---------##
----|---------##
---####--####|##
---####--####|##
U
D