##|-----------##
##|-----------##
##|-----------##
##|-----------##
##|-----------##
##|-----------##
##|---------####
##|---------####
##BB------######
##BB------######
######--########
######--------##
######--------##
#############|##
#############|##
U
D