----------------
----------------
----------------
----------------
----------------
----------------
----------------
----------------
----------------
----------------
-----###########
-----#########--
---|##########--
---|############
---|############
R
D