---|------######
---|------######
---|----------##
---|----------##
---|--######--##
---|--######--##
------##----BB##
------C#----BB##
--|#####|#######
--|#####|#######
--|---##|-----##
--|---C#|-----##
--|---######|###
--|---######|###
--|---######|###