----|-##|-----##
----|-##|-----##
----|-##|-----##
----|-##|-----##
----|-##|-----##
----|-##|-----##
----|-##|-----##
----|-##|-----##
----|-##|-----##
----|-##|-----##
--------------##
--------------##
############|###
############|###
############|###
U
D