---|--------|-##
---|--------|-##
---|--------|-##
---|--------|-##
------##########
--##--##########
------BBBBBB--##
------BBBBBB-U##
--|#############
--|#############
--|-----------##
--|-----------##
--##|#######|###
--##|#######|###
--##|#######|###