##-|----------##
##-|----------##
##-|----------##
##-|----------##
##-|----------##
##-##--------L##
##-##-------####
##-##---------##
##-###C-------##
##------------##
##------#C----##
##------------##
##------------##
###|#--######|##
###|#--######|##
U
D