-------------###
-------------###
-------------###
-------------###
-------------###
-------------###
--------------DD
--------------DD
--------------DD
--------------DD
----------######
----------######
--|#############
--|#############
--|#############