##-|---------|##
##-|---------|##
##-|---------|##
##-#---------|##
##-----------|##
##--M------M-###
##------------##
##----M--M----##
##------------##
##------------##
##-------#----##
##------------##
##------------##
##-----|##----##
##-----|##----##
U
D