---|----########
---|----########
---|------######
---|------######
---|------######
---|------######
#######|########
#######|########
#######|--######
#######|--######
########------##
##------------##
##---www-MMMM|##
##-|####-----|##
##-|---------|##
U
D