----------------
----------------
----------------
----------------
----------------
----------------
----------------
----------------
----------------
----------------
-----###########
-----#########--
---|##########L-
---|############
---|############
R
D