##-|----------##
##-|----------##
##-|----------##
##-|----------##
##------------##
##----#######|##
##-----------|##
##l----------|##
###l---------|##
####------#|####
####-------|--##
####l------|--##
#####C-----|--##
#############|##
#############|##
U
D