--------------##
--------------##
--------------##
--------------##
--------------##
--------------##
####--#C--##--##
####--##--##--##
--###C##--##--##
--##########--##
--######------##
--######------##
########lll---##
############-|##
############-|##
D
L