############-|##
############-|##
####--######-|##
####--######-|##
####---------|##
####---------|##
############-|##
####---------|##
####----------##
####----------##
##------------##
##------------##
##------#C--#C##
##-|##--########
##-|##--########
D
U