--------------##
--------------##
--------------##
--------------##
--------------##
--------------##
--------------##
--------------##
--##########--##
---#-#---###--##
---#-#---####-##
---#-#---###--##
---#-#---###--##
HHH#H#HHH###--##
############-###
D
L