####--##--##--##
####--##--##--##
####--##--##--##
####--##--##--##
##------------##
##--------L---##
##--------##--##
##ll------##--##
####------##--##
####--w---##--##
####--##------##
####HH##------##
########--##--##
########--##--##
########--##--##
D
U