########--##--##
########--##--##
##------------##
##------------##
##----##------##
##+---##------##
####--##------##
####--##------##
####--##------##
####--##------##
####----------##
####-----l--HH##
####--##########
####--##########
####--##########
D
U