##------------##
##------------##
##------------##
##--##--M-----##
##--##--------##
##--##--------##
##--##----M---##
##--##--------##
##--##--M----M##
##--##M-------##
##--##-----M--##
##--##--M-----##
##--##--------##
##--##--------##
##--############
D
U