#############|##
#############|##
###########--|##
###########--|##
#########----###
#########----###
######----##-###
######----##-###
-------##-######
-------##-######
----##-##C######
----##-#########
######C#########
################
################
U
L