##------------##
##------------##
##------------##
##--############
##------------##
##------------##
##------------##
##------------##
####--#--#--#-##
####HH#HH#HH#-##
#############-##
##------------##
##------------##
##|#############
##|#############
D
U