----------------
----------------
----------------
----------------
----------------
----------------
----------------
----------------
######---####---
----------------
------------l---
------------##--
----------------
----------------
----------------
R
U