----------######
----------######
----------######
----------######
----------######
----------######
----------######
----------######
--------------##
--------------##
#############|##
-------######|##
--------#####|##
---------####|##
----------###|##