##----##########
##----##########
##----##########
##----##########
##----##########
####--##########
##------------##
##------------##
##------------##
##------------##
##------------##
##------------##
##########----##
##########----##
##########----##
D
U