##########----##
##########----##
##########----##
##########----##
##########--####
##########----##
##------------##
##------------##
##------------##
##------------##
##------------##
##------------##
##----##########
##----##########
##----##########
D
U