----------------
#######---------
----------------
###--------M----
--#-------------
###-------------
###-------------
###-------######
###-####--######
###-####|-######
###L####|-######
################
################
################
############----
