###------#######
-##|#-M--#######
-##|#-----------
---|#-----------
---|#-----------
-####-----------
-####-----------
####-CC---------
####------------
----------------
######|#########
######|#########
######|#########
---###|#########
------|#########
