####------------
----------------
----------------
----------------
----------------
HHHHH-----------
-----|#---------
-----|#---------
#|---|#-----##--
#|---|##########
#|---|##########
#|---|##########
-----|######--##
-----|#######-##
#----|#######-##
