###########-----
---------##-----
---------##-----
----------------
----------------
############----
############--##
############--##
############--##
-#########----##
##########----##
---#######----##
###-----------##
###C####C---ww##
################
