#-##--##|#######
#-##--##|#######
---#--##|#######
##-#--##|#######
---#--##|#######
HHHH####|-------
########|-------
########|-------
########|-------
----------------
----------------
----------------
################
################
---#############
