##-------####|##
---------####|##
#--------####|##
----HHHHH####|##
HHHH#########|##
#############|##
#############|##
#############|##
#############|##
----------------
#####-----------
----------------
----------------
----------HHHHH-
#####-##HH#####|
