---C------######
####------######
---------#######
-----|##H-------
-----|###-------
#----|###-------
#----|###-------
-----|#########-
###############-
################
#######---------
HHHHHHHHHHHHH---
----------------
#######---------
#######----|####
