-------------###
###----------###
------------####
#---------------
################
################
################
################
################
################
################
################
################
################
################
