---####---------
#######HH-M-----
---######-------
---######-------
---######-------
HHH-------------
###------------#
HHH------------#
---###########--
---###########--
##############--
----------------
----------------
############|###
############|###
