#######---------
##--------------
----------------
-------#########
################
----############
----------------
----------------
----------------
----------------
----------------
####------------
HHHHHHHHHHHHHHHH
HHHHHHHHHHHHHHHH
HHHHHHHHHHHHHHHH
