####------------
----------------
---------####---
---------####---
HHHHHHHHH----C--
#########-------
-------##M------
--M-#####-------
----#####M------
----#####-------
----#####-------
##--#####-----L-
----------######
#######---######
#######---######
