------|---#-----
##----|---#-----
------|---------
------|---------
-###--|---------
-###--|---------
-###--|------###
####--|------###
------|---------
------|---------
###---|--######-
########-#######
####-----#######
####-----#######
####-----#######
