#####-----------
----------##----
----------##----
----------##----
----------##----
#---------------
#---------------
-----------#####
-----------#####
################
################
################
################
---#############
################
