#--------------#
#lll-----------#
#####----------#
HHHHH######----#
###########----#
###########---w#
#-----#####--###
H----------CC###
-#CC------------
##CC-----------W
------####--####
##----####--####
##-#######--####
##C#######--####
##########--####
