---------------|
---------------|
----#######----|
----#######----|
----#######----|
----------#----|
----------#----|
################
################
--------BBB-####
################
----------------
----------------
----------------
###|------------
