----------------
----------------
HHHHHHHHHHH---#-
-------------|#-
###CC#-------|#-
###CC#-------|#-
-------------|#-
#####--------###
##-----------###
##---------#####
##---------#####
##---------#####
##---------#---#
##--------------
##|######|######
