#######-----|###
-######-----|###
#####---#---|###
#####---##--|###
#####---##L-|###
--------####|###
--------####|---
##------####|---
----------##|---
----------##|---
###-------##|---
###C--------|###
-##C--------|###
######|-----|---
######|-----|---
