##|###|######---
--|###|######---
--|###|######---
#-|###|######---
--|---|######---
--###########---
#############---
#############---
HHHHHHHHHHHHH---
-------------|--
#------------|--
#----------#####
#-##############
#|##############
-|##############
