------####------
------##--------
----------------
#########-------
#########C###---
----------------
#####|----------
--###|----------
-----|----------
-----|###-------
#----|----------
-----|----------
--#--######-----
HH---######-----
----------------
