####--M---------
---#------------
---#------------
---#------------
---#######------
##########|##---
##########|##-##
##########|##-##
---------#|##-##
##-------#|---##
##|------#|---##
##|------####|##
--|------####|##
#############|##
#############|##
