-----------###|#
###-----------|#
###-----------|#
--------------|#
#########-----|#
#########-----|#
#########-----|#
##--#####-----|#
-#--####------|#
##--####------|#
##--####------|#
HH--####------|#
##--####------|#
HH######------|-
###############H
