#----------|#---
H----------|#---
-####------##---
H####------##---
H####------##---
H###------------
H###------------
####------------
-----------####-
#----------####-
#----------####-
#---------------
----------------
###############l
################
