-------|########
#------|-----###
#-######---#-###
#-######---#-###
H#######---#-###
########---#----
---#####---#--M-
HHH#####---#----
HHH#########----
HHH#------------
####------###---
####------###---
HHHH########----
############--##
############--##
