---###----------
H---##----------
-#####----------
H------##-------
H------##----|--
#------------|--
---------|######
################
-------#########
####------------
####------##|###
####ll------|###
########----|###
########----|###
################
