----|----|-#####
#---|----|-#####
----|----|-#####
#-#####|-|-###--
--########-###--
HH--------------
--#######|#####-
HH--#####|#####-
----#####|#####-
----#####|#####-
----#####|#####-
----#####|#####+
HHHH#####|######
#########|######
#########|######
