------####-----#
#-----####-----#
#-----#--------#
H-----#--------#
#-----#--------#
#-----#--------#
------##-------#
###---##-#######
###|--##-##--###
###|--##-##--###
------##|##--###
-------#|##--###
##|---##|##-----
########|##-----
########|#######
