################
--##############
################
---#############
#--#############
#--#######---###
#--#######---###
H--#######---###
#--#######---###
---------#---###
---------#---###
########C#---###
##########---###
-#########-#####
##########-####-
