HHHHHH----------
----------------
#########-------
----------------
##---------##|##
-----------##|##
#####|-----##|##
#####|###--##---
#####-----------
-####-----------
H####-----------
#####-----------
#####-----------
#########HHHHHHH
################
