######--B--#----
--####--B--#----
#-########-###--
--########C###--
--############CC
--#########-----
HH--------------
--##------------
HH--------------
--####----------
--####-------###
######-MM----###
######-------###
#########----###
--#######HHHH###
