---------------|
---------------|
---------------|
--######-------|
--######HHH----|
--#########----|
--####---------|
------------###|
------------###|
---------------|
---------------|
---------------|
------#L-------|
####|###--M----|
--##|###------##
