----------------
##--------------
##------#####---
-#-----M#####---
H-------#####---
-|------#####---
-|------#####---
-|------#####---
-|------#####---
-|--###-#####---
-|------#------M
-|--------------
#######---######
HHHHHHH#########
###############-
