--------###-----
----------#-----
----------------
----------------
----------------
#---------------
H---------------
-#--------------
H---------------
H---------------
####------------
####lllll-------
#########|######
#########|######
#########|######
