-----|----------
-----|----------
HH---|----------
--#--|----------
HH---|----------
HH---|----------
--P--|----------
######----------
-----#----------
-----#----------
####-#----------
----------------
#######|#|#-----
#######|#|#ttt##
-######|#|#ttt##
