#######--#--####
#######--#--####
------------####
#-----------####
#----------M####
#-----------####
H-------|##-####
-#------|##C####
##------|##C####
##--###-|#######
##|-----|#######
--|-----|#######
##|-----|#######
--|-############
################
