######----------
HHHHHH----------
------#######---
------#######---
------#######---
-#----#########-
-#-----------##-
##-----------##-
##-----------###
-#-----------###
-------------###
#|---------#####
-|----------####
#|-|----------##
#|-|----------##
