----------------
-----BB---------
##|--BB---------
-----BB---------
#----BB---------
H----BB-HH------
-#########------
-#########|-----
H-########|-----
-#########|-----
-C########|-----
-############---
-#############--
H-----########--
#-############--
