--------##|-----
--------##|-----
##########|-----
----------|-----
----------|-----
######----|-----
HHHHHH----|-----
----------------
-----------###|-
-----------###|-
---#------------
####------######
####--##########
####|-##########
####|-##########
