################
---------#######
---------#------
--------##------
HHH-----##------
###-----##------
###-------C#####
###-------######
###-------######
--------MM######
####------######
----------######
################
################
################
