#---------------
H----#----------
#|##-#------|---
#|##-#------|---
#|##-#########|#
#|##-#########|#
#-##-#########|#
#-##-#########|#
-----#########|#
##############|#
##############|#
##############|#
--------######|#
--------######|#
##############|#
