-------##-------
-----####-------
-----####-------
#----####|------
-----####|######
####-----|######
HHHH-----|######
####-----|######
####-----|------
---------|------
---------|------
#--------|------
#--------|######
-------##|######
#########|######
