##--------------
----------------
----------------
##--------######
##----##########
HH----#####--###
#####L#####--###
###########--###
--#########--###
#|#########--###
-|##############
#|##############
-|##############
#|##############
#|##############
