H#---------##---
##---------##---
----------------
-----------#----
HHHHHHH--###----
-------|-###----
##-----|-###----
------######---#
#####-######---C
#####----------#
HHHHH----------#
-----###-------#
########----####
------------####
####|##|----####
