##----#|#H------
-#-####|##------
-#-####|##------
-#-####|--------
---####|#######-
-------|#######-
##-----|#######-
HH-----|#######-
##-----|#######-
##-----|#######-
##-----|#######-
##---##|########
##---##|########
##HHH##|########
##HHH##|########
