-------#|#####--
######-#|#####--
######-#|#######
######-#|#######
######--|#######
######--|#######
######--|######-
--------|######-
HHH-----|######-
###--|--#######-
###--|--#######-
-----C##########
################
----------######
###|############
