##------########
##------########
HH------###-----
##------###-----
-##########-----
###########-----
----------------
----#-----------
#|--------------
#|----####|##--#
#|-------#|##--#
########-#|##HH#
########--|##HH#
########--|#####
----####--|#####
