#####---#####---
--------#####---
--------#####---
#############---
#############---
-------######---
-------#######--
-------#######--
-------########-
-------########-
------U########-
#|#############l
#|##############
#|##############
#|##############
