---------C-----#
#--------#-----#
#--------#-----#
#--------#-----#
----------------
#-------------##
#-------------##
--------------##
----------------
----------------
----------------
HHHHHHHHHHHHH---
-------------###
################
################
