#--------###--##
#--------###--##
#--------###--##
#--------###---#
-----#######---#
##|--#######---#
##|--###########
##|--###########
##B--######-----
###--######-w--#
###--######-####
--#########C####
################
-##########-####
-##########-####
