---|##----------
---|##----##|---
---|##------|---
-#######|---|---
########|---|---
#########---|---
#########---|---
-###############
################
-###############
H---------------
-|--------------
#|###-----------
#|###-----------
#|###----------#
