-#####--#---##--
-#####--#-------
----------##----
####------##----
####------######
####----########
HHHH----########
####---------###
####---------###
--##---------###
####--------W###
####------######
####------######
####------######
####------######
