##--------------
##--------------
##--------------
##--------------
##|#############
##|-----------##
##|-----------##
##|-----------##
#############|##
##-----------|##
##-----------|##
##------P----|##
################
HHHHHHHHHHHHHHHH
HHHHHHHHHHHHHHHH
