--------------##
--------------##
--------------##
--------------##
#############|##
-------------|##
-------------|##
-------------|##
|###############
|---------------
|---------------
|---------------
################
HHHHHHHHHHHHHHHH
HHHHHHHHHHHHHHHH
