####---------|##
####---------|##
####---------|##
####L--------|##
######----#|####
####-------|--##
##---------|--##
##---------|--##
-----------|--##
-----------|--##
------#C---|--##
------##---|--##
####--##--##--##
HHHHHH##HHHHHHHH
HHHHHH##HHHHHHHH
