##--|-------####
##--|---------##
##--|---------##
##--|---------##
##--|---------##
##--CC####CC|-##
##--CC####CC|-##
##----------|-##
##----------|-##
###|CC######CC##
###|CC######CC##
##-|--------####
##-|--------####
###########|####
###########|####
