----------------
----------------
----------------
----------------
----------------
----------------
--------####----
--------###C----
#C----####------
--------##----#-
--------##------
C----#--##------
--------####--##
-###---###----##
--------##----##
