#---------------
#---------------
#---------------
#---------------
#-------------##
#-------------##
#-----------####
#-----------####
#---------######
#---------####--
#-------######--
#-------######--
#-----##########
##--|#####HHHHHH
##--|#####HHHHHH
