----------------
----------------
----------------
--W-------------
--|-------------
--|-------------
--|-------------
--|-------------
--|-------------
--|-------------
--|-------------
--|-------------
####--##--##--##
HHHHHHHHHHHHHH##
HHHHHHHHHHHHHH##
