##--------------
##--------------
##--------------
##------------WW
##--------######
##--------######
##--------######
##--------######
##--------######
##--------------
##-|###C--------
##-|####--######
##-|#####C######
##-|############
##-|############
