###########|####
###########|####
########---|####
########---|####
-----------|####
-----------|####
-----------|####
-----------|####
-----------|####
-----------|####
--#C--##########
--##--------####
--##------------
HH##HHHHHHHHHHHH
HH##HHHHHHHHHHHH
