------##-#######
------##-#######
------##-#######
------##------##
------##------##
-----|##------##
-----|##------##
-----|##------##
--W--|##------##
--#--|##------##
-----|##------##
-----|##------##
-----|--------##
-----|--------##
-----########|##
