----------##-###
----------##-###
----------##-###
----------##-###
----------##-###
----------##--##
---------###--##
--------####--##
-------#####--##
------##------##
------##------##
------##------##
------##------##
------##------##
------##|#######
