----------###-##
----------###-##
----------###-##
--+-------##--##
--#-------##--##
----------##-###
--------------##
--------------##
------#######-##
---------###--##
----------##--##
----------##-###
----------##--##
----------##--##
----------###|##
