@@@@@@@@@@@@@@@@
----------------
----------------
----------------
----------------
----------------
----------------
----------------
----------------
######---####---
----------------
------------w---
------------##--
----------------
----------------
