----##tt########
##------------##
##------------##
##------------##
##------------##
##------------##
##------------##
##------------##
##------------##
##------------##
##------------##
##------------##
##------------##
##tt############
##tt############
