################
################
################
################
################
################
################
################
################
################
----------------
----------------
###########-----
################
################
