----------------
#---------------
----------------
----------------
#########-------
----------------
----------------
----------------
----------------
####------------
################
################
################
################
################
