----------------
----------------
----------------
----------------
##----------#---
------------####
################
################
################
################
######--########
--------########
################
################
################
