HHHHHHHHHHHHHHHH
HHHHHHHHHHHHHHHH
HHHHHHHHHHHHHHHH
HHHHHHHHHHHHHHHH
################
################
################
-------------###
----------------
#############C--
----------------
----------------
----------------
################
################
