#########-------
#########---####
#########|######
---------|######
------##########
################
----------------
----------------
----------------
----------------
----------------
----------------
#####---------MM
#####----P------
################
