#######---------
#######--------#
---------------#
###------------#
-##------------#
###-------------
###-------------
----------------
----------------
----------------
##--------------
#----------#####
--------########
---#############
################
