##########------
##########--####
##########-|####
##########-|####
################
--------------##
----------------
----------------
###-------------
------------###-
#-----------###-
-B--------------
##--------------
################
################
