####-----######-
################
################
################
################
################
----############
################
################
################
################
################
----------------
----------------
#---------------
