#---------------
#-----------####
#-----------####
#-----|#########
------|#########
------|---------
------|---------
----------------
----------------
----------------
######----------
----------------
----------------
----------------
----------------
