----------------
----------------
----------------
----------------
##--------------
----------------
###########-----
###########-----
----------------
#######---------
----------------
----------------
----------------
----------------
######----------
