----------------
##--------------
----------------
----------------
##########------
----------------
########--------
########|#######
########|#######
########|#######
########|#######
--------|#######
################
################
################
