##########------
----------------
----------------
----------------
----------------
----------------
#######---------
----------------
----------------
----------------
############----
################
################
################
################
