----####--------
----####--------
########--------
----------------
----------------
----------------
----------------
##--------------
-------########-
--P----########-
###############-
--------------#-
###############-
----------------
----------------
