#######---------
#######--#######
---------#######
---------######-
--------#######-
################
--------########
----------------
----------------
----------------
----------------
----------------
######----------
---###----------
######----------
