-------------#--
##############--
#---------------
#|--------######
#|##############
#|##############
#|##############
#|##############
#|##############
#|##############
#|##############
#|##############
-|----------####
-BB-------------
###-------------
