#####|----------
-----|##########
###############-
################
################
################
################
################
################
################
################
########---#####
########---#####
################
################
