################
################
----------------
###-------------
###-------------
----------------
----------------
----------------
###-------------
----------------
##--------------
----------------
----------------
----------------
----------------
