----------------
----------------
----------------
-#####----------
######--------##
#-##############
################
----------######
################
################
################
################
################
################
################
