################
################
################
################
----------------
#---------------
#---------------
#---------------
################
################
################
################
-###############
################
################
