----------------
----------------
----------------
----------#####-
---------|#####-
######---|#####-
---------|-####-
###############-
################
################
################
################
################
################
################
