-------------###
####|###########
--##|---########
--##|---#-------
####|####-------
----|###########
###-|-##########
################
################
################
---------#######
---------###----
####|-------B---
----|########---
################
