----------------
-----------####-
--#############-
###############-
--------########
###---##########
###--------#####
###------#######
--------------##
----------------
###-------------
----------------
----------------
----------#-----
HHHHHHHHHH#-----
