----------------
----------------
----------------
----------------
----------------
--------------##
--------------#-
--------------#-
--------------#-
#############-#-
#######-------#-
----------------
---------#------
---------#------
#--------#------
