----------------
----------------
----------------
#############---
################
################
---#############
################
################
----############
################
################
################
################
################
