----------------
--------#-------
--------####----
--------####----
############----
############----
----------------
--------------M-
----------------
#--------------W
-------------###
################
################
################
################
