----------------
----------------
----------------
----------------
##|#############
##|#############
#-|#############
--|#############
--|-------------
--|-------------
######----------
######---------#
#############--#
################
################
