################
################
################
################
################
################
################
----############
#######---------
----------------
----------------
----------------
----------------
########--------
----------######
