----------------
----------------
-----##---------
-----##---------
----------------
----------------
#---------------
#---------------
----------------
##-#######------
##|#######------
--|-------------
################
################
################
