##-----------###
##----------####
-----------#####
######----------
######----------
----------------
####-----###----
---------###----
###########C----
----------------
##############--
################
################
################
------##########
