###----------###
###----------###
###----------###
----------------
----------------
----------------
######-------###
######-------###
####--P------###
###########--###
###########--###
################
################
################
################
