----------------
----------------
----------------
----------------
----------------
----------------
----------------
----------------
############----
--------########
----------------
####------------
####-###########
################
################
