----------------
----------------
----------------
----------------
----------------
---###----------
---###----------
########--------
########--######
########--######
----------######
----------#-----
###########-----
####-------+----
####------######
