----------------
----------------
####|----#######
----|----#######
----|----#####--
--##############
################
################
################
################
--##############
################
------##########
################
################
