----------------
----------------
----------------
----------------
----------------
----------------
-----B----------
----BB----------
###########-----
######----------
-----#----------
-----#----------
######------####
################
################
