################
######---------#
######---------#
---###---------#
----------------
-#######--------
########--------
########-------#
###------------#
###-############
###-############
###-############
###-############
----############
################
