################
################
################
--##############
################
##----##########
################
################
################
################
----------------
----------------
----------------
##--------------
----------------
