----------------
----------------
----------------
----------------
----------------
----------------
----------------
----------------
----------------
--#############-
--#############-
###############-
----------------
########-#######
HHHHHHHH########
