----------------
#---------------
----------------
----------------
----------------
----------------
----------------
##--------------
----------------
----------------
----------------
------------#---
------------#---
------------#---
################
