----------------
----------------
----------------
----------------
----------------
----------------
----------------
----------------
----------------
----------------
----------#C#---
----------######
################
################
################