################
################
################
################
######--------##
######--------##
--------------##
--------------##
--------------##
--------------##
######----------
######----------
################
################
################