################
################
################
################
##----------####
##------W---####
##------BB------
##------BB------
##------BB------
##------BB------
##--------------
##--------------
##|#############
##|#############
##|#############
