################
################
################
################
################
######--##--####
##--##--##--####
----------------
----------------
----------------
----------------
################
################
################
################
