################
################
################
################
################
################
################
##--##--##--##--
----------------
----------------
----------------
----------------
##--##--##--##--
################
################
