###############-
###############-
########--------
########--------
########|#######
########|-----##
########|-----##
########|-----##
--###########|##
--######-----|##
-------------|##
-------------|##
################
################
################
