----############
----############
----------------
----------------
----------------
--------------#-
----------------
----------------
--#-MMMMMMM-----
----------------
----------------
----------------
HHHHHHHHHHHHHHHH
################
################
