################
################
--------------##
--------------##
---|############
---|--------####
--------------##
--------------##
-MMMMMMMMMMMMMMM
------+----*--##
------#----#--##
--------------##
HHHHHHHHHHHHHH##
################
################
