----------------
----------------
----------------
----------------
----------------
----------------
----------------
----------------
----------------
----------------
----------######
----------######
################
################
################