----------------
----------------
----------------
----------------
----------------
----------------
----------------
----------------
--------------##
--------------##
------------####
--------P---####
################
################
################