----------------
----------------
----------------
----------------
----------------
----------------
----------------
----------------
----------------
----------------
----------###---
----------###---
################
################
################