##--------------
##--------------
##--------------
##--------------
##--------------
##--------------
##--------------
##------P-------
#############---
#####-----------
####------------
###-------------
##--------------
##--------------	
##--------------	