----------------
----------------
----------------
----------------
----------------
----------------
----------------
----------------
######---####---
----------------
----------------
------------##--
----------------
----------------	
----------------	