@@@@@@@@@@@VHHH
@@@@@@@@@@@V@@@
@@@@@@VHHHHV@@@
@@@@@@V@@@@@@@@
HHHHHHV@@@@@@@@
