HHHV@@@@
@@@V@@@@
@@@VHV@@
@@@@@V@@
@@@@@VHV
@@@@@@@V
@@@@@@@V
@@@@@@@V
@@@@@@@V
@@@@@@@V
