----|---##--|-##
----|---##--|-##
----|---##--|-##
--------##--|-##
--------##--|-##
--------##--|-##
------####----##
--------##----##
--##----BB----##
--------BB----##
------######|###
------####--|-##
--#|######--|-##
--#|######--|-##
--#|######--|-##
