----|---##--|-##
----|---##--|-##
----|---##--|-##
----|---##--|-##
--##|---##--|-##
--------##--|-C#
------####--|-##
--------##--|-##
--|###--BB--|-##
--|-----BB--|-C#
--|-------##|-##
--|-------##|-##
###|--######|###
###|########|###
###|########|###
